id,name,latitude,longitude,departures,arrivals,combined,docks,launch
35,"Streeter Dr & Grand Ave",41.892278,-87.612043,392240,392240,784480,47,2013
76,"Lake Shore Dr & Monroe St",41.880958,-87.616743,246431,246431,492862,39,2013
91,"Clinton St & Washington Blvd",41.88338,-87.64117,236984,236984,473968,31,2013
192,"Canal St & Adams St",41.879255,-87.639904,220380,220380,440760,47,2013
177,"Theater on the Lake",41.926277,-87.630834,216946,216946,433892,31,2013
268,"Lake Shore Dr & North Blvd",41.911722,-87.626804,197060,197060,394120,39,2013
85,"Michigan Ave & Oak St",41.90096039,-87.62377664,193362,193362,386724,23,2013
77,"Clinton St & Madison St",41.882242,-87.641066,192482,192482,384964,31,2013
90,"Millennium Park",41.8810317,-87.62408432,190813,190813,381626,47,2013
174,"Canal St & Madison St",41.882091,-87.639833,174565,174565,349130,35,2013
195,"Columbus Dr & Randolph St",41.884728,-87.619521,159355,159355,318710,55,2013
43,"Michigan Ave & Washington St",41.88355,-87.62418,154577,154577,309154,43,2013
287,"Franklin St & Monroe St",41.880317,-87.635185,146255,146255,292510,27,2013
81,"Daley Center Plaza",41.884241,-87.629634,134282,134282,268564,39,2013
26,"McClurg Ct & Illinois St",41.890359,-87.617532,129267,129267,258534,31,2013
52,"Michigan Ave & Lake St",41.886024,-87.624117,122980,122980,245960,35,2013
133,"Kingsbury St & Kinzie St",41.88917683258,-87.6385057718,120780,120780,241560,31,2015
283,"LaSalle St & Jackson Blvd",41.878166,-87.631929,120142,120142,240284,35,2013
36,"Franklin St & Jackson Blvd",41.8777079559,-87.6353211408,116839,116839,233678,39,2013
110,"Dearborn St & Erie St",41.893992,-87.629318,116802,116802,233604,27,2013
75,"Canal St & Jackson Blvd",41.877245,-87.639366,116086,116086,232172,39,2013
255,"Indiana Ave & Roosevelt Rd",41.867888,-87.623041,116018,116018,232036,39,2013
49,"Dearborn St & Monroe St",41.881319815,-87.6295209193,115497,115497,230994,39,2013
176,"Clark St & Elm St",41.902973,-87.63128,115273,115273,230546,39,2013
100,"Orleans St & Merchandise Mart Plaza",41.888243,-87.63639,114537,114537,229074,35,2013
199,"Wabash Ave & Grand Ave",41.891466,-87.626761,111415,111415,222830,31,2013
66,"Clinton St & Lake St",41.885637,-87.641823,109345,109345,218690,23,2013
289,"Wells St & Concord Ln",41.912133,-87.634656,108114,108114,216228,19,2013
181,"LaSalle St & Illinois St",41.890762,-87.631697,107597,107597,215194,31,2013
59,"Wabash Ave & Roosevelt Rd",41.867227,-87.625961,107595,107595,215190,23,2013
94,"Clark St & Armitage Ave",41.918306,-87.636282,107169,107169,214338,31,2013
3,"Shedd Aquarium",41.86722595682,-87.6153553902,106822,106822,213644,55,2015
24,"Fairbanks Ct & Grand Ave",41.89186,-87.62062,103352,103352,206704,15,2013
47,"State St & Kinzie St",41.889187,-87.627754,102169,102169,204338,31,2013
211,"St. Clair St & Erie St",41.894448,-87.622663,100398,100398,200796,19,2013
141,"Clark St & Lincoln Ave",41.915689,-87.6346,100280,100280,200560,23,2013
48,"Larrabee St & Kingsbury St",41.897764,-87.642884,98905,98905,197810,43,2013
56,"Desplaines St & Kinzie St",41.888716036,-87.6444478533,96772,96772,193544,27,2013
74,"Kingsbury St & Erie St",41.893626,-87.641527,96184,96184,192368,23,2013
341,"Adler Planetarium",41.866095,-87.607267,95159,95159,190318,39,2013
69,"Damen Ave & Pierce Ave",41.9093960065,-87.6776919292,93375,93375,186750,23,2013
97,"Field Museum",41.865312,-87.617867,91655,91655,183310,55,2013
284,"Michigan Ave & Jackson Blvd",41.87785,-87.62408,91273,91273,182546,23,2013
44,"State St & Randolph St",41.8847302006,-87.6277335692,90312,90312,180624,27,2013
117,"Wilton Ave & Belmont Ave",41.94018,-87.65304,89654,89654,179308,27,2013
99,"Lake Shore Dr & Ohio St",41.89257,-87.614492,88222,88222,176444,19,2013
140,"Dearborn Pkwy & Delaware Pl",41.898969,-87.629912,86788,86788,173576,19,2013
37,"Dearborn St & Adams St",41.8793563587,-87.6297910363,85248,85248,170496,19,2013
53,"Wells St & Huron St",41.894722,-87.634362,84345,84345,168690,27,2013
51,"Clark St & Randolph St",41.884576228,-87.63188991,84289,84289,168578,39,2013
191,"Canal St & Monroe St (*)",41.88169,-87.63953,82394,82394,164788,28,2013
212,"Wells St & Hubbard St",41.889906,-87.634266,80618,80618,161236,31,2013
67,"Sheffield Ave & Fullerton Ave",41.9256018819,-87.6537080423,80147,80147,160294,27,2013
58,"Marshfield Ave & Cortland St",41.916017,-87.668879,80039,80039,160078,23,2013
31,"Franklin St & Chicago Ave",41.896776,-87.635633,78396,78396,156792,23,2013
173,"Mies van der Rohe Way & Chicago Ave",41.89691,-87.621743,76055,76055,152110,15,2013
334,"Lake Shore Dr & Belmont Ave",41.940775,-87.639192,75837,75837,151674,19,2013
164,"Franklin St & Lake St",41.885837,-87.6355,75800,75800,151600,27,2013
6,"Dusable Harbor",41.886976,-87.612813,74777,74777,149554,39,2015
286,"Franklin St & Quincy St",41.878724,-87.634793,74365,74365,148730,23,2013
134,"Peoria St & Jackson Blvd",41.877749,-87.649633,74193,74193,148386,19,2013
98,"LaSalle St & Washington St",41.882664,-87.63253,73697,73697,147394,15,2013
210,"Ashland Ave & Division St",41.90345,-87.667747,73526,73526,147052,27,2013
25,"Michigan Ave & Pearson St",41.89766,-87.62351,72491,72491,144982,23,2013
340,"Clark St & Wrightwood Ave",41.929546,-87.643118,72428,72428,144856,15,2013
249,"Montrose Harbor",41.963982,-87.638181,71665,71665,143330,31,2013
198,"Green St & Madison St",41.881892,-87.648789,71552,71552,143104,27,2013
4,"Burnham Harbor",41.856268,-87.613348,70794,70794,141588,23,2015
33,"State St & Van Buren St",41.877181,-87.627844,70255,70255,140510,27,2013
313,"Lakeview Ave & Fullerton Pkwy",41.925858,-87.638973,70088,70088,140176,19,2013
114,"Sheffield Ave & Waveland Ave",41.949399,-87.654529,69596,69596,139192,27,2013
71,"Morgan St & Lake St",41.8854833079,-87.6523048564,68587,68587,137174,23,2013
301,"Clark St & Schiller St",41.907993,-87.631501,68242,68242,136484,19,2013
300,"Broadway & Barry Ave",41.937725,-87.644095,67717,67717,135434,19,2013
264,"Stetson Ave & South Water St",41.886835,-87.62232,66922,66922,133844,19,2013
220,"Clark St & Drummond Pl",41.931248,-87.644336,66754,66754,133508,23,2013
194,"Wabash Ave & Wacker Pl",41.886875,-87.62603,66378,66378,132756,19,2013
240,"Sheridan Rd & Irving Park Rd",41.954245,-87.654406,65452,65452,130904,27,2013
291,"Wells St & Evergreen Ave",41.906724,-87.63483,65274,65274,130548,19,2013
50,"Clark St & Ida B Wells Dr",41.8759326655,-87.6305845355,64853,64853,129706,35,2013
143,"Sedgwick St & Webster Ave",41.922167,-87.638888,64546,64546,129092,15,2013
112,"Green St & Randolph St",41.883668,-87.64867,64512,64512,129024,15,2013
157,"Lake Shore Dr & Wellington Ave",41.936669,-87.636794,64493,64493,128986,15,2013
144,"Larrabee St & Webster Ave",41.921822,-87.64414,63425,63425,126850,19,2013
115,"Sheffield Ave & Wellington Ave",41.936266,-87.652662,62996,62996,125992,23,2013
321,"Wabash Ave & 9th St",41.870769,-87.625734,62782,62782,125564,19,2013
196,"Cityfront Plaza Dr & Pioneer Ct",41.890573,-87.622072,62112,62112,124224,31,2013
13,"Wilton Ave & Diversey Pkwy",41.932418,-87.652705,61975,61975,123950,35,2013
156,"Clark St & Wellington Ave",41.9364968219,-87.6475386582,61437,61437,122874,15,2013
126,"Clark St & North Ave",41.911974,-87.631942,61011,61011,122022,15,2013
38,"Clark St & Lake St",41.88602082773,-87.6308760584,59246,59246,118492,27,2015
18,"Wacker Dr & Washington St",41.883132,-87.637321,59153,59153,118306,19,2015
344,"Ravenswood Ave & Lawrence Ave",41.96909,-87.674237,59099,59099,118198,47,2013
197,"Michigan Ave & Madison St",41.882134,-87.625125,58967,58967,117934,19,2013
118,"Sedgwick St & North Ave",41.911386,-87.638677,58903,58903,117806,19,2013
113,"Bissell St & Armitage Ave",41.91844,-87.65222,58713,58713,117426,15,2013
229,"Southport Ave & Roscoe St",41.943739,-87.66402,58587,58587,117174,19,2013
45,"Michigan Ave & Ida B Wells Dr",41.876243,-87.624426,58502,58502,117004,15,2013
153,"Southport Ave & Wellington Ave",41.935733,-87.663576,58431,58431,116862,19,2013
241,"Morgan St & Polk St",41.871737,-87.65103,58030,58030,116060,19,2013
142,"McClurg Ct & Erie St",41.894503,-87.617854,56462,56462,112924,31,2015
60,"Dayton St & North Ave",41.9105780349,-87.6494219288,55830,55830,111660,19,2013
106,"State St & Pearson St",41.897448,-87.628722,55746,55746,111492,27,2013
73,"Jefferson St & Monroe St",41.880422,-87.642746,55540,55540,111080,19,2013
303,"Broadway & Cornelia Ave",41.945529,-87.646439,55464,55464,110928,23,2013
254,"Pine Grove Ave & Irving Park Rd",41.954383,-87.648043,55404,55404,110808,15,2013
232,"Pine Grove Ave & Waveland Ave",41.949275,-87.646303,55210,55210,110420,23,2013
61,"Wood St & Milwaukee Ave",41.907655,-87.672552,54795,54795,109590,19,2013
145,"Mies van der Rohe Way & Chestnut St",41.8985866514,-87.6219152258,54756,54756,109512,19,2015
329,"Lake Shore Dr & Diversey Pkwy",41.932588,-87.636427,54263,54263,108526,23,2013
80,"Aberdeen St & Monroe St",41.880419,-87.655519,53947,53947,107894,19,2013
337,"Clark St & Chicago Ave",41.89675,-87.63089,53659,53659,107318,19,2013
299,"Halsted St & Roscoe St",41.94367,-87.64895,53334,53334,106668,15,2013
150,"Fort Dearborn Dr & 31st St",41.838556,-87.608218,53311,53311,106622,27,2013
2,"Buckingham Fountain",41.87647,-87.62034,52757,52757,105514,39,2015
331,"Halsted St & Clybourn Ave (*)",41.909668,-87.648128,52555,52555,105110,28,2013
84,"Milwaukee Ave & Grand Ave",41.891578,-87.648384,52329,52329,104658,19,2013
327,"Sheffield Ave & Webster Ave",41.92154,-87.653818,52163,52163,104326,19,2013
128,"Damen Ave & Chicago Ave",41.895769,-87.67722,51456,51456,102912,19,2013
296,"Broadway & Belmont Ave",41.940106,-87.645451,51213,51213,102426,19,2013
227,"Southport Ave & Waveland Ave",41.94815,-87.66394,50844,50844,101688,23,2013
130,"Damen Ave & Division St",41.903266,-87.678435,50605,50605,101210,19,2013
21,"Aberdeen St & Jackson Blvd",41.87772613,-87.65478743,50033,50033,100066,23,2013
111,"Sedgwick St & Huron St",41.894666,-87.638437,49767,49767,99534,27,2013
20,"Sheffield Ave & Kingsbury St",41.910522,-87.653106,48311,48311,96622,15,2013
304,"Broadway & Waveland Ave",41.949074,-87.648636,47684,47684,95368,15,2013
273,"Michigan Ave & 18th St",41.857813,-87.62455,47386,47386,94772,23,2013
34,"Cannon Dr & Fullerton Ave",41.9267559875,-87.6344287848,47249,47249,94498,15,2013
349,"Halsted St & Wrightwood Ave",41.929143,-87.649077,47093,47093,94186,15,2013
123,"California Ave & Milwaukee Ave",41.922695,-87.697153,46893,46893,93786,15,2013
41,"Federal St & Polk St",41.87207763285,-87.6295437729,46786,46786,93572,19,2015
127,"Lincoln Ave & Fullerton Ave",41.925905,-87.64926,46766,46766,93532,15,2013
161,"Rush St & Superior St",41.89576474564,-87.6259080327,46013,46013,92026,23,2015
5,"State St & Harrison St",41.874053,-87.627716,45626,45626,91252,23,2013
39,"Wabash Ave & Adams St",41.87947235235,-87.6256886059,44326,44326,88652,23,2015
125,"Rush St & Hubbard St",41.890173,-87.626185,44311,44311,88622,23,2015
175,"Wells St & Polk St",41.872596,-87.633502,44294,44294,88588,19,2013
260,"Kedzie Ave & Milwaukee Ave",41.929567,-87.707857,44161,44161,88322,35,2013
168,"Michigan Ave & 14th St",41.864059,-87.623727,43995,43995,87990,19,2013
219,"Damen Ave & Cortland St",41.915983,-87.677335,43706,43706,87412,19,2013
225,"Halsted St & Dickens Ave",41.919936,-87.64883,43674,43674,87348,23,2013
93,"Sheffield Ave & Willow St",41.913688,-87.652855,43620,43620,87240,15,2013
338,"Calumet Ave & 18th St",41.857611,-87.619407,43594,43594,87188,15,2013
182,"Wells St & Elm St",41.903222,-87.634324,43583,43583,87166,23,2015
230,"Lincoln Ave & Roscoe St",41.94334,-87.67097,43492,43492,86984,19,2013
324,"Stockton Dr & Wrightwood Ave",41.93132,-87.638742,42759,42759,85518,15,2013
46,"Wells St & Walton St",41.89993001,-87.63443007,42716,42716,85432,19,2013
332,"Burling St (Halsted) & Diversey Pkwy (Temp)",41.93314,-87.64776,42621,42621,85242,19,2013
233,"Sangamon St & Washington Blvd (*)",41.883165,-87.6511,42533,42533,85066,16,2013
320,"Loomis St & Lexington St",41.872187,-87.661501,42293,42293,84586,19,2013
172,"Rush St & Cedar St",41.90230870122,-87.627690528,42292,42292,84584,11,2015
54,"Ogden Ave & Chicago Ave",41.896362458,-87.6540612729,41718,41718,83436,19,2013
152,"Lincoln Ave & Diversey Pkwy",41.932225,-87.658617,41323,41323,82646,15,2013
72,"Wabash Ave & 16th St",41.860384,-87.625813,41301,41301,82602,39,2013
7,"Field Blvd & South Water St",41.88634906269,-87.6175165471,41226,41226,82452,19,2015
302,"Sheffield Ave & Wrightwood Ave",41.928712,-87.653833,41157,41157,82314,31,2013
107,"Desplaines St & Jackson Blvd",41.878287,-87.643909,41140,41140,82280,27,2015
29,"Noble St & Milwaukee Ave",41.90068,-87.6626,40887,40887,81774,15,2013
459,"Lakefront Trail & Bryn Mawr Ave",41.98403669612,-87.6523104689,40097,40097,80194,19,2015
108,"Halsted St & Polk St",41.87184,-87.64664,40082,40082,80164,19,2013
22,"May St & Taylor St",41.8694821,-87.6554864,39733,39733,79466,15,2013
231,"Sheridan Rd & Montrose Ave",41.96167,-87.65464,39674,39674,79348,23,2013
223,"Clifton Ave & Armitage Ave",41.918216,-87.656936,39600,39600,79200,15,2013
342,"Wolcott Ave & Polk St",41.871262,-87.673688,39361,39361,78722,23,2013
158,"Milwaukee Ave & Wabansia Ave",41.912616,-87.681391,39120,39120,78240,15,2013
226,"Racine Ave & Belmont Ave",41.939743,-87.658865,38680,38680,77360,15,2013
346,"Ada St & Washington Blvd",41.88283,-87.661206,38618,38618,77236,15,2013
96,"Desplaines St & Randolph St",41.88461618962,-87.6445705849,38463,38463,76926,23,2015
19,"Loomis St & Taylor St (*)",41.868968,-87.659141,38233,38233,76466,16,2013
87,"Racine Ave & Fullerton Ave",41.92556258,-87.65840426,37684,37684,75368,19,2013
217,"Racine Ave (May St) & Fulton St",41.886926,-87.656919,37383,37383,74766,15,2013
17,"Honore St & Division St",41.903119,-87.673935,37355,37355,74710,23,2013
89,"Financial Pl & Ida B Wells Dr (Temp)",41.874618,-87.632882,37307,37307,74614,15,2015
183,"Damen Ave & Thomas St (Augusta Blvd)",41.901315,-87.677409,37303,37303,74606,23,2013
57,"Clinton St & Roosevelt Rd",41.8671177825,-87.6410879593,36955,36955,73910,15,2013
190,"Southport Ave & Wrightwood Ave",41.928773,-87.663913,36777,36777,73554,15,2013
165,"Clark St & Grace St",41.95078,-87.659172,36519,36519,73038,23,2013
40,"LaSalle St & Adams St",41.87934437346,-87.6319852213,36311,36311,72622,15,2015
116,"Western Ave & Winnebago Ave",41.91552,-87.687022,36111,36111,72222,15,2013
312,"Clarendon Ave & Gordon Ter",41.957879,-87.649519,35780,35780,71560,15,2013
16,"Paulina Ave & North Ave",41.910337,-87.670072,35588,35588,71176,15,2013
68,"Clinton St & Tilden St",41.875885,-87.640795,35588,35588,71176,23,2013
423,"University Ave & 57th St",41.791478,-87.599861,35131,35131,70262,31,2015
62,"McCormick Place",41.8513751729,-87.6188346489,35000,35000,70000,27,2013
88,"Racine Ave & Randolph St",41.884069,-87.656853,34946,34946,69892,19,2013
307,"Southport Ave & Clybourn Ave",41.920771,-87.663712,34583,34583,69166,15,2013
359,"Larrabee St & Division St",41.90348607004,-87.6433534936,33809,33809,67618,23,2015
325,"Clark St & Winnemac Ave",41.97334,-87.66778,33349,33349,66698,19,2013
247,"Shore Dr & 55th St",41.795212,-87.580715,32883,32883,65766,19,2013
237,"MLK Jr Dr & 29th St",41.842052,-87.617,32827,32827,65654,19,2013
288,"Larrabee St & Armitage Ave",41.918084,-87.643749,32788,32788,65576,15,2013
186,"Ogden Ave & Race Ave",41.891795,-87.658751,32686,32686,65372,15,2013
224,"Halsted St & Willow St",41.913865,-87.648755,32595,32595,65190,19,2013
350,"Ashland Ave & Chicago Ave",41.895966,-87.667747,31648,31648,63296,15,2013
131,"Lincoln Ave & Belmont Ave",41.939365,-87.668385,31381,31381,62762,15,2013
256,"Broadway & Sheridan Rd",41.952833,-87.649993,31190,31190,62380,15,2013
282,"Halsted St & Maxwell St",41.864883,-87.647071,31167,31167,62334,15,2013
364,"Larrabee St & Oak St",41.90021949323,-87.6429854676,31102,31102,62204,19,2015
86,"Eckhart Park",41.89637337,-87.66098386,30943,30943,61886,19,2013
138,"Clybourn Ave & Division St",41.904613,-87.640552,30752,30752,61504,15,2013
245,"Clarendon Ave & Junior Ter",41.961004,-87.649603,30632,30632,61264,23,2013
333,"Ashland Ave & Blackhawk St",41.907066,-87.667252,30599,30599,61198,15,2013
92,"Carpenter St & Huron St",41.894556,-87.653449,29995,29995,59990,19,2013
180,"Ritchie Ct & Banks St",41.906866,-87.626217,29587,29587,59174,15,2015
154,"Southport Ave & Belmont Ave",41.93949,-87.66378,29321,29321,58642,15,2013
148,"State St & 33rd St",41.834734,-87.625813,28767,28767,57534,15,2013
28,"Larrabee St & Menomonee St",41.91468,-87.64332,28375,28375,56750,15,2013
322,"Kimbark Ave & 53rd St",41.799568,-87.594747,28291,28291,56582,19,2013
294,"Broadway & Berwyn Ave",41.978353,-87.659753,28125,28125,56250,15,2013
188,"Greenview Ave & Fullerton Ave",41.92533,-87.6658,28078,28078,56156,15,2013
306,"Sheridan Rd & Buena Ave",41.958494,-87.654966,27698,27698,55396,19,2013
318,"Southport Ave & Irving Park Rd",41.954177,-87.664358,27540,27540,55080,15,2013
214,"Damen Ave & Grand Ave",41.89122,-87.67686,27529,27529,55058,23,2013
30,"Ashland Ave & Augusta Blvd",41.899643,-87.6677,27376,27376,54752,15,2013
261,"Hermitage Ave & Polk St",41.871514,-87.669886,27367,27367,54734,15,2013
239,"Western Ave & Leland Ave",41.966555,-87.688487,27256,27256,54512,19,2013
32,"Racine Ave & Congress Pkwy",41.87464,-87.65703,27089,27089,54178,19,2013
317,"Wood St & Taylor St",41.869154,-87.671045,26914,26914,53828,23,2013
213,"Leavitt St & North Ave",41.910153,-87.68229,26265,26265,52530,15,2013
120,"Wentworth Ave & Cermak Rd (Temp)",41.853005,-87.630578,26054,26054,52108,19,2013
109,"900 W Harrison St",41.874754,-87.649807,25529,25529,51058,19,2013
463,"Clark St & Berwyn Ave",41.9779966544,-87.6680471047,25517,25517,51034,19,2015
343,"Racine Ave & Wrightwood Ave",41.928887,-87.658971,25220,25220,50440,15,2013
129,"Blue Island Ave & 18th St",41.857556,-87.661535,25160,25160,50320,15,2013
242,"Damen Ave & Leland Ave",41.967094,-87.679028,24995,24995,49990,15,2013
328,"Ellis Ave & 58th St",41.788746,-87.601334,24541,24541,49082,19,2013
23,"Orleans St & Elm St (*)",41.902924,-87.637715,24358,24358,48716,16,2013
55,"Halsted St & Roosevelt Rd",41.867324,-87.648625,24307,24307,48614,23,2013
244,"Ravenswood Ave & Irving Park Rd",41.95469,-87.67393,23970,23970,47940,19,2013
243,"Lincoln Ave & Sunnyside Ave",41.963004,-87.684781,23838,23838,47676,15,2013
137,"Morgan Ave & 14th Pl",41.862378,-87.651062,23439,23439,46878,15,2013
305,"Western Ave & Division St",41.902893,-87.687275,23395,23395,46790,23,2013
293,"Broadway & Wilson Ave",41.965221,-87.658139,23015,23015,46030,23,2013
146,"Loomis St & Jackson Blvd",41.877945,-87.662007,22989,22989,45978,19,2013
258,"Logan Blvd & Elston Ave",41.929465,-87.684158,22940,22940,45880,27,2013
298,"Lincoln Ave & Belle Plaine Ave",41.95602,-87.680293,22671,22671,45342,15,2013
119,"Ashland Ave & Lake St (Temp)",41.88592,-87.66717,22665,22665,45330,19,2013
347,"Ashland Ave & Grace St",41.950687,-87.6687,22639,22639,45278,15,2013
420,"Ellis Ave & 55th St",41.79430062054,-87.6014497734,22516,22516,45032,19,2015
27,"Larrabee St & North Ave",41.91021,-87.6435,22297,22297,44594,19,2013
326,"Clark St & Leland Ave",41.967096,-87.667429,22122,22122,44244,19,2013
166,"Ashland Ave & Wrightwood Ave",41.92883,-87.668507,21878,21878,43756,15,2013
309,"Leavitt St & Armitage Ave",41.917805,-87.682437,21792,21792,43584,11,2013
234,"Clark St & Montrose Ave",41.961588,-87.666036,21600,21600,43200,19,2013
414,"Canal St & Taylor St",41.870257,-87.639474,21527,21527,43054,15,2015
623,"Michigan Ave & 8th St",41.872773,-87.623981,21393,21393,42786,43,2017
15,"Racine Ave & 18th St",41.858166,-87.656495,21306,21306,42612,15,2013
238,"Wolcott (Ravenswood) Ave & Montrose Ave (*)",41.961406,-87.676169,21232,21232,42464,16,2013
310,"Damen Ave & Charleston St",41.920082,-87.677855,21154,21154,42308,11,2013
251,"Clarendon Ave & Leland Ave",41.967968,-87.650001,20959,20959,41918,15,2013
290,"Kedzie Ave & Palmer Ct",41.921525,-87.707322,20770,20770,41540,15,2013
345,"Lake Park Ave & 56th St",41.793242,-87.587782,20748,20748,41496,19,2013
295,"Broadway & Argyle St",41.973815,-87.65966,20745,20745,41490,19,2013
257,"Lincoln Ave & Waveland Ave",41.948797,-87.675278,20539,20539,41078,15,2013
374,"Western Ave & Walton St",41.89841768945,-87.6865960164,20362,20362,40724,23,2015
426,"Ellis Ave & 60th St",41.78509714636,-87.6010727606,20301,20301,40602,19,2015
376,"Artesian Ave & Hubbard St",41.88949181977,-87.6882193648,20246,20246,40492,35,2015
253,"Winthrop Ave & Lawrence Ave",41.968812,-87.657659,20217,20217,40434,15,2013
417,"Cornell Ave & Hyde Park Blvd",41.802406,-87.586924,19668,19668,39336,19,2015
277,"Ashland Ave & Grand Ave",41.891072,-87.666611,19651,19651,39302,15,2013
169,"Canal St & Harrison St",41.874255,-87.639573,19576,19576,39152,15,2013
250,"Ashland Ave & Wellington Ave",41.936083,-87.669807,19484,19484,38968,19,2013
383,"Paulina St & Flournoy St",41.87295,-87.66913,19457,19457,38914,31,2015
14,"Morgan St & 18th St",41.858086,-87.651073,19433,19433,38866,15,2013
285,"Wood St & Hubbard St",41.889899,-87.671473,19137,19137,38274,19,2013
162,"Damen Ave & Wellington Ave",41.93588,-87.67842,18970,18970,37940,15,2013
259,"California Ave & Francis Pl",41.918121,-87.696972,18602,18602,37204,15,2013
314,"Ravenswood Ave & Berteau Ave",41.957921,-87.673567,18458,18458,36916,15,2013
319,"Greenview Ave & Diversey Pkwy",41.932595,-87.665939,18423,18423,36846,15,2013
308,"Seeley Ave & Roscoe St",41.943403,-87.679618,17916,17916,35832,11,2013
205,"Paulina St & 18th St",41.857901,-87.668745,17498,17498,34996,15,2013
160,"Campbell Ave & North Ave",41.910535,-87.689556,17373,17373,34746,15,2013
511,"Albany Ave & Bloomingdale Ave",41.91402671273,-87.705126462,17193,17193,34386,15,2015
507,"Humboldt Blvd & Armitage Ave",41.91751339399,-87.7018089555,16928,16928,33856,19,2015
465,"Marine Dr & Ainslie St",41.9716,-87.650154,16626,16626,33252,23,2015
178,"State St & 19th St",41.856594,-87.627542,16210,16210,32420,15,2013
248,"Woodlawn Ave & 55th St",41.795264,-87.596471,15918,15918,31836,19,2013
228,"Damen Ave & Melrose Ave",41.9406,-87.6785,15867,15867,31734,15,2013
454,"Broadway & Granville Ave",41.9947796884,-87.6602845349,15834,15834,31668,23,2015
163,"Damen Ave & Clybourn Ave",41.931931,-87.677856,15808,15808,31616,15,2013
149,"Calumet Ave & 33rd St",41.8349,-87.61793,15749,15749,31498,11,2013
272,"Indiana Ave & 31st St",41.838842,-87.621857,15666,15666,31332,11,2013
42,"Wabash Ave & Cermak Rd",41.852619,-87.626488,15606,15606,31212,11,2013
315,"Elston Ave & Wabansia Ave",41.912919,-87.664169,15277,15277,30554,23,2013
276,"California Ave & North Ave",41.91044,-87.6972,15072,15072,30144,11,2013
458,"Broadway & Thorndale Ave",41.98974251144,-87.6601406209,15042,15042,30084,19,2015
424,"Museum of Science and Industry",41.79172820953,-87.583945009,15024,15024,30048,27,2015
460,"Clark St & Bryn Mawr Ave",41.983593,-87.669154,14976,14976,29952,15,2015
419,"Lake Park Ave & 53rd St",41.79949429373,-87.5864498959,14790,14790,29580,15,2015
394,"Clark St & 9th St (AMLI)",41.870816,-87.631246,14666,14666,29332,15,2015
311,"Leavitt St & Lawrence Ave",41.968885,-87.684001,14594,14594,29188,19,2013
316,"Damen Ave & Sunnyside Ave",41.96325,-87.679258,14516,14516,29032,19,2013
461,"Broadway & Ridge Ave",41.9840446107,-87.6602738295,14496,14496,28992,15,2015
323,"Sheridan Rd & Lawrence Ave",41.969517,-87.654691,14416,14416,28832,19,2013
292,"Southport Ave & Clark St",41.957081,-87.664199,14261,14261,28522,11,2013
339,"Emerald Ave & 31st St",41.838198,-87.645143,14170,14170,28340,11,2013
202,"Halsted St & 18th St",41.857499,-87.646277,14121,14121,28242,15,2013
222,"Milwaukee Ave & Rockwell St",41.920195,-87.693033,13873,13873,27746,19,2013
451,"Sheridan Rd & Loyola Ave",42.00104377979,-87.6611982433,13790,13790,27580,23,2015
184,"State St & 35th St",41.8309,-87.62803,13640,13640,27280,19,2013
370,"Calumet Ave & 21st St",41.85418424947,-87.6191537415,13632,13632,27264,15,2015
620,"Orleans St & Chestnut St (NEXT Apts)",41.898203,-87.637536,13630,13630,27260,15,2016
159,"Claremont Ave & Hirsch St",41.907781,-87.685854,13620,13620,27240,11,2013
122,"Ogden Ave & Congress Pkwy",41.87501,-87.67328,13539,13539,27078,15,2013
236,"Sedgwick St & Schiller St",41.907626,-87.638566,13493,13493,26986,15,2013
121,"Blackstone Ave & Hyde Park Blvd",41.802562,-87.590368,13485,13485,26970,19,2013
464,"Damen Ave & Foster Ave",41.97561480459,-87.6794590387,13467,13467,26934,15,2015
216,"California Ave & Division St",41.903029,-87.697474,13382,13382,26764,15,2013
170,"Clinton St & 18th St",41.85795,-87.640826,13192,13192,26384,15,2013
418,"Ellis Ave & 53rd St",41.79933626261,-87.6009581145,13098,13098,26196,11,2015
246,"Ashland Ave & Belle Plaine Ave",41.956057,-87.668835,13071,13071,26142,11,2013
267,"Lake Park Ave & 47th St",41.809443,-87.591875,13029,13029,26058,15,2013
447,"Glenwood Ave & Morse Ave",42.00797192287,-87.6655023944,12935,12935,25870,15,2015
215,"Damen Ave & Madison St",41.88137,-87.67493,12917,12917,25834,15,2013
596,"Benson Ave & Church St",42.048214,-87.683485,12824,12824,25648,15,2016
506,"Spaulding Ave & Armitage Ave",41.91718375155,-87.7103566522,12258,12258,24516,15,2015
330,"Lincoln Ave & Addison St",41.946176,-87.673308,12208,12208,24416,19,2013
274,"Racine Ave & 15th St",41.861267,-87.656625,11954,11954,23908,15,2013
297,"Paulina St & Montrose Ave",41.961507,-87.671387,11810,11810,23620,15,2013
185,"Stave St & Armitage Ave",41.917741,-87.691392,11653,11653,23306,11,2013
206,"Halsted St & Archer Ave",41.847203,-87.646795,11505,11505,23010,15,2013
493,"Western Ave & Roscoe St",41.943034,-87.687288,11426,11426,22852,11,2015
263,"Rhodes Ave & 32nd St",41.836208,-87.613533,11213,11213,22426,11,2013
504,"Campbell Ave & Fullerton Ave",41.92463247165,-87.6893070063,10885,10885,21770,15,2015
147,"Indiana Ave & 26th St",41.845687,-87.622481,10786,10786,21572,15,2013
280,"Morgan St & 31st St",41.8378,-87.65114,9651,9651,19302,11,2013
432,"Clark St & Lunt Ave",42.009074,-87.67419,9446,9446,18892,19,2015
502,"California Ave & Altgeld St",41.92669,-87.697668,9443,9443,18886,15,2015
207,"Emerald Ave & 28th St",41.84358,-87.645368,9391,9391,18782,15,2013
478,"Rockwell St & Eastwood Ave",41.96590013976,-87.6936384935,9014,9014,18028,15,2015
365,"Halsted St & North Branch St",41.89936843921,-87.6484798752,8764,8764,17528,15,2015
505,"Winchester Ave & Elston Ave",41.92409085038,-87.6764600747,8734,8734,17468,15,2015
501,"Richmond St & Diversey Ave",41.93190196886,-87.7011951301,8675,8675,17350,15,2015
457,"Clark St & Elmdale Ave",41.990887,-87.669758,8667,8667,17334,19,2015
482,"Campbell Ave & Montrose Ave",41.96152593287,-87.6911650414,8651,8651,17302,15,2015
124,"Damen Ave & Cullerton St",41.855048,-87.675726,8501,8501,17002,15,2013
103,"Clinton St & Polk St (*)",41.87146651779,-87.6409491327,8328,8328,16656,16,2015
503,"Drake Ave & Fullerton Ave",41.924398819,-87.7154410355,8317,8317,16634,15,2015
275,"Ashland Ave & 13th St",41.865234,-87.666507,8302,8302,16604,15,2013
425,"Harper Ave & 59th St",41.78794281287,-87.5883151702,8215,8215,16430,15,2015
402,"Shields Ave & 31st St",41.838464,-87.635406,8057,8057,16114,15,2015
462,"Winchester (Ravenswood) Ave & Balmoral Ave",41.979762,-87.67753,8004,8004,16008,15,2015
627,"LaSalle Dr & Huron St (*)",41.894877,-87.632326,7949,7949,15898,20,2018
279,"Halsted St & 35th St (*)",41.830661,-87.647172,7733,7733,15466,16,2013
605,"University Library (NU)",42.052939,-87.673447,7651,7651,15302,15,2016
252,"Greenwood Ave & 47th St",41.809835,-87.599383,7640,7640,15280,15,2013
204,"Prairie Ave & Garfield Blvd",41.794853,-87.618691,7614,7614,15228,11,2013
491,"Talman Ave & Addison St",41.9466358306,-87.694614758,7586,7586,15172,15,2015
434,"Ogden Ave & Roosevelt Rd",41.86650148316,-87.68469707,7582,7582,15164,19,2015
604,"Sheridan Rd & Noyes St (NU)",42.058239,-87.677432,7579,7579,15158,15,2016
597,"Chicago Ave & Washington St",42.032562,-87.679101,7363,7363,14726,15,2016
490,"Troy St & Elston Ave",41.94524356848,-87.7066499009,7341,7341,14682,15,2015
171,"May St & Cullerton St",41.855136,-87.654127,7334,7334,14668,11,2013
509,"Troy St & North Ave",41.90976930169,-87.7052804871,7318,7318,14636,15,2015
135,"Halsted St & 21st St",41.85378,-87.64665,7315,7315,14630,11,2013
218,"Wells St & 19th St",41.856802,-87.633879,7292,7292,14584,11,2013
486,"Oakley Ave & Irving Park Rd",41.95434085219,-87.6860796243,7286,7286,14572,15,2015
278,"Wallace St & 35th St",41.830629,-87.64129,7056,7056,14112,15,2013
132,"Wentworth Ave & 24th St",41.849237,-87.631715,6992,6992,13984,15,2013
354,"Sheridan Rd & Greenleaf Ave",42.01058656284,-87.6624120948,6920,6920,13840,15,2015
403,"Wentworth Ave & 33rd St",41.83452988563,-87.6318229814,6914,6914,13828,15,2015
497,"Kimball Ave & Belmont Ave",41.939398,-87.711561,6908,6908,13816,15,2015
624,"Dearborn St & Van Buren St (*)",41.876268,-87.629155,6885,6885,13770,16,2017
492,"Leavitt St & Addison St",41.946655,-87.683359,6805,6805,13610,15,2015
603,"Chicago Ave & Sheridan Rd",42.050491,-87.677821,6745,6745,13490,15,2016
265,"Cottage Grove Ave & Oakwood Blvd",41.822985,-87.6071,6638,6638,13276,15,2013
621,"Aberdeen St & Randolph St",41.884114,-87.654264,6602,6602,13204,15,2018
449,"Clark St & Columbia Ave",42.00445062934,-87.6724024047,6575,6575,13150,15,2015
626,"Delano Ct & Roosevelt Rd",41.867491,-87.63219,6502,6502,13004,19,2017
471,"Francisco Ave & Foster Ave",41.97563272521,-87.7014194389,6357,6357,12714,15,2015
382,"Western Ave & Congress Pkwy",41.87474885079,-87.6864452757,6338,6338,12676,19,2015
209,"Normal Ave & Archer Ave",41.849527,-87.640591,6208,6208,12416,11,2013
498,"California Ave & Fletcher St",41.93842879148,-87.698007756,6179,6179,12358,19,2015
472,"Lincoln Ave & Winona St",41.97491129677,-87.6925025594,6080,6080,12160,15,2015
499,"Kosciuszko Park",41.93058537138,-87.7237773635,6054,6054,12108,15,2015
203,"Western Ave & 21st St",41.854109,-87.685838,5978,5978,11956,15,2013
622,"California Ave & Cortez St",41.900363,-87.696704,5919,5919,11838,15,2017
475,"Washtenaw Ave & Lawrence Ave",41.968987,-87.696027,5912,5912,11824,15,2015
523,"Eastlake Ter & Rogers Ave",42.021019,-87.665086,5774,5774,11548,15,2016
520,"Greenview Ave & Jarvis Ave",42.015962,-87.66857,5551,5551,11102,19,2016
453,"Clark St & Schreiber Ave",41.99925182186,-87.6713773393,5506,5506,11012,15,2015
406,"Lake Park Ave & 35th St",41.83127423549,-87.6087991946,5486,5486,10972,19,2015
489,"Drake Ave & Addison St",41.947326,-87.717582,5433,5433,10866,15,2015
474,"Christiana Ave & Lawrence Ave",41.96835449363,-87.7118306675,5274,5274,10548,15,2015
136,"Racine Ave & 13th St",41.865054,-87.656959,5224,5224,10448,15,2013
208,"Ashland Ave & 21st St",41.85381,-87.665897,5139,5139,10278,15,2013
483,"Avondale Ave & Irving Park Rd",41.953393,-87.732002,5096,5096,10192,19,2015
515,"Paulina St & Howard St",42.019159,-87.673573,4909,4909,9818,19,2016
479,"Drake Ave & Montrose Ave",41.96115407569,-87.7165690733,4900,4900,9800,15,2015
481,"California Ave & Montrose Ave",41.961068,-87.695439,4717,4717,9434,15,2015
484,"Monticello Ave & Irving Park Rd",41.95400483876,-87.7191281797,4583,4583,9166,15,2015
335,"Calumet Ave & 35th St",41.831379,-87.618034,4515,4515,9030,15,2013
487,"California Ave & Byron St",41.95216219326,-87.698051113,4440,4440,8880,19,2015
476,"Kedzie Ave & Leland Ave",41.96668636205,-87.7080519806,4394,4394,8788,15,2015
401,"Shields Ave & 28th Pl",41.842733,-87.635491,4329,4329,8658,11,2015
508,"Central Park Ave & North Ave",41.90965687563,-87.7166319516,4260,4260,8520,15,2015
101,"63rd St Beach",41.78101637196,-87.5761197602,4227,4227,8454,15,2015
381,"Western Ave & Monroe St",41.8797877089,-87.686112808,4127,4127,8254,15,2015
179,"MLK Jr Dr & Pershing Rd",41.8246,-87.61678,4059,4059,8118,15,2013
477,"Manor Ave & Leland Ave",41.965875,-87.700825,4057,4057,8114,11,2015
348,"California Ave & 21st St",41.854016,-87.695445,4031,4031,8062,15,2013
405,"Wentworth Ave & 35th St",41.830777,-87.632504,3966,3966,7932,15,2016
336,"Cottage Grove Ave & 47th St",41.809855,-87.606755,3959,3959,7918,15,2013
485,"Sawyer Ave & Irving Park Rd",41.95358617895,-87.7093107999,3898,3898,7796,15,2015
500,"Central Park Ave & Elbridge Ave",41.93533728263,-87.7168892935,3894,3894,7788,15,2015
510,"Spaulding Ave & Division St",41.90270659438,-87.709219571,3797,3797,7594,11,2015
496,"Avers Ave & Belmont Ave",41.939408,-87.723574,3786,3786,7572,11,2015
480,"Albany Ave & Montrose Ave",41.961041,-87.705866,3743,3743,7486,11,2015
469,"St. Louis Ave & Balmoral Ave",41.98039423475,-87.7161149615,3660,3660,7320,15,2015
413,"Woodlawn Ave & Lake Park Ave",41.81409271048,-87.5970051479,3588,3588,7176,15,2015
366,"Loomis St & Archer Ave",41.84163253965,-87.6574349533,3585,3585,7170,11,2015
470,"Kedzie Ave & Foster Ave",41.975672,-87.709261,3413,3413,6826,11,2015
351,"Cottage Grove Ave & 51st St",41.803038,-87.606615,3306,3306,6612,15,2013
377,"Kedzie Ave & Lake St",41.88460328501,-87.7063037436,3294,3294,6588,15,2015
467,"Western Ave & Lunt Ave",42.0085943972,-87.6904922389,3252,3252,6504,15,2015
9,"Leavitt St & Archer Ave",41.82879201994,-87.6806044594,3216,3216,6432,15,2015
193,"State St & 29th St",41.841707,-87.626938,3173,3173,6346,11,2013
416,"Dorchester Ave & 49th St",41.805772,-87.592464,3061,3061,6122,15,2015
638,"Clinton St & Jackson Blvd (*)",41.878419,-87.640977,3061,3061,6122,32,2018
602,"Central St & Girard Ave",42.064313,-87.686152,2973,2973,5946,15,2016
437,"Washtenaw Ave & Ogden Ave (*)",41.861894,-87.693511,2876,2876,5752,16,2015
601,"Central St Metra",42.063598,-87.69873,2863,2863,5726,15,2016
355,"South Shore Dr & 67th St",41.773643,-87.567514,2831,2831,5662,15,2015
422,"DuSable Museum",41.79156801058,-87.6078521774,2778,2778,5556,11,2015
367,"Racine Ave & 35th St",41.83069611252,-87.6559759116,2696,2696,5392,15,2015
442,"California Ave & 23rd Pl",41.84910969176,-87.6951398068,2664,2664,5328,11,2015
452,"Western Ave & Granville Ave",41.99416136902,-87.689438282,2654,2654,5308,11,2015
12,"South Shore Dr & 71st St",41.7664094567,-87.5656875719,2629,2629,5258,15,2015
378,"California Ave & Lake St",41.88445395657,-87.6962981368,2596,2596,5192,11,2015
625,"Chicago Ave & Dempster St",42.041691,-87.680687,2568,2568,5136,15,2017
271,"Cottage Grove Ave & 43rd St",41.816499,-87.606582,2525,2525,5050,11,2013
495,"Keystone Ave & Montrose Ave",41.96110801623,-87.7289701012,2520,2520,5040,11,2015
262,"Halsted St & 37th St",41.827059,-87.64572,2506,2506,5012,11,2013
200,"MLK Jr Dr & 47th St",41.809851,-87.616279,2456,2456,4912,11,2013
281,"Western Ave & 24th St",41.84847,-87.685109,2456,2456,4912,7,2013
427,"Cottage Grove Ave & 63rd St",41.78059901484,-87.606112388,2436,2436,4872,15,2015
468,"Budlong Woods Library",41.98366470886,-87.6964225611,2397,2397,4794,11,2015
373,"Kedzie Ave & Chicago Ave",41.89546530305,-87.7061278837,2371,2371,4742,11,2015
494,"Kedzie Ave & Bryn Mawr Ave",41.98239708485,-87.7089225202,2313,2313,4626,15,2015
448,"Warren Park East",42.00454962194,-87.6806661451,2196,2196,4392,11,2015
466,"Ridge Blvd & Touhy Ave",42.01213227742,-87.6829126443,2159,2159,4318,11,2015
600,"Dodge Ave & Church St",42.048308,-87.698224,2130,2130,4260,15,2016
517,"Clark St & Jarvis Ave",42.015963,-87.675005,2074,2074,4148,11,2016
450,"Warren Park West",42.001785,-87.688829,2053,2053,4106,11,2015
428,"Dorchester Ave & 63rd St",41.7804056457,-87.5914159893,2052,2052,4104,11,2015
436,"Fairfield Ave & Roosevelt Rd",41.866624,-87.694521,2015,2015,4030,11,2015
352,"Jeffery Blvd & 67th St",41.77351755125,-87.5771428255,1991,1991,3982,11,2015
201,"Indiana Ave & 40th St",41.82168,-87.6216,1966,1966,3932,11,2013
619,"Keystone Ave & Fullerton Ave",41.92459,-87.72785,1963,1963,3926,11,2016
525,"Glenwood Ave & Touhy Ave",42.012701,-87.666058,1943,1943,3886,15,2016
353,"Clark St & Touhy Ave",42.01256011541,-87.6743671152,1934,1934,3868,15,2015
167,"Damen Ave & Coulter St",41.8492,-87.67564,1920,1920,3840,7,2013
415,"Calumet Ave & 51st St",41.80229465088,-87.6180535802,1915,1915,3830,11,2015
522,"Bosworth Ave & Howard St",42.019537,-87.669563,1870,1870,3740,11,2016
456,"2112 W Peterson Ave",41.991178,-87.683593,1845,1845,3690,11,2015
368,"Ashland Ave & Archer Ave",41.83920868403,-87.6656098589,1759,1759,3518,15,2015
455,"Maplewood Ave & Peterson Ave",41.99023602867,-87.6933696402,1737,1737,3474,11,2015
399,"South Shore Dr & 74th St",41.76218896038,-87.55927465,1679,1679,3358,11,2015
636,"Orleans St & Hubbard St (*)",41.890028,-87.636618,1677,1677,3354,12,2018
590,"Kilbourn Ave & Irving Park Rd",41.953733,-87.740569,1588,1588,3176,11,2016
410,"Prairie Ave & 43rd St",41.81665889302,-87.6194124619,1586,1586,3172,15,2015
514,"Ridge Blvd & Howard St",42.019276,-87.68452,1561,1561,3122,11,2016
598,"Elmwood Ave & Austin St",42.025784,-87.684107,1517,1517,3034,15,2016
435,"Kedzie Ave & Roosevelt Rd",41.86649278172,-87.7064961757,1503,1503,3006,11,2015
518,"Conservatory Dr & Lake St",41.885502,-87.716866,1491,1491,2982,11,2016
369,"Wood St & 35th St",41.83010465416,-87.6702983089,1461,1461,2922,11,2015
439,"Kedzie Ave & 21st St",41.85353363213,-87.7050730318,1407,1407,2814,11,2015
375,"Sacramento Blvd & Franklin Blvd",41.889727,-87.70103,1402,1402,2804,11,2015
102,"Stony Island Ave & 67th St",41.77345849948,-87.5853397391,1377,1377,2754,11,2015
488,"Pulaski Rd & Eddy St (Temp)",41.946264,-87.731023,1361,1361,2722,11,2015
635,"Fairbanks St & Superior St (*)",41.895748,-87.620104,1346,1346,2692,12,2018
95,"Stony Island Ave & 64th St",41.778881,-87.586647,1324,1324,2648,11,2015
592,"Knox Ave & Montrose Ave",41.960631,-87.745359,1306,1306,2612,11,2016
527,"Western Ave & Howard St",42.018901,-87.690048,1273,1273,2546,15,2016
385,"Princeton Ave & Garfield Blvd",41.794982,-87.633124,1186,1186,2372,11,2015
11,"Jeffery Blvd & 71st St",41.76663823695,-87.5764501141,1167,1167,2334,11,2015
411,"Halsted St & 47th Pl",41.80813391481,-87.6456165545,1150,1150,2300,11,2015
591,"Kilbourn Ave & Milwaukee Ave",41.948818,-87.74002,1149,1149,2298,15,2016
412,"Princeton Ave & 47th St",41.80931770924,-87.633449288,1059,1059,2118,11,2015
526,"Oakley Ave & Touhy Ave",42.012342,-87.688243,1016,1016,2032,11,2016
599,"Valli Produce - Evanston Plaza",42.039742,-87.699413,1014,1014,2028,15,2016
438,"Central Park Ave & Ogden Ave",41.85420431327,-87.7154058381,1006,1006,2012,15,2015
356,"Stony Island Ave & 71st St",41.7664929373,-87.5864608775,917,917,1834,11,2015
445,"California Ave & 26th St",41.84404003127,-87.6952959227,912,912,1824,11,2015
532,"Austin Blvd & Lake St",41.887919,-87.774446,904,904,1808,11,2016
589,"Milwaukee Ave & Cuyler Ave",41.954468,-87.749594,888,888,1776,11,2016
657,"Wood St & Augusta Blvd",41.899181,-87.6722,871,871,1742,15,2018
429,"Cottage Grove Ave & 67th St",41.77372095205,-87.60563486,865,865,1730,11,2015
443,"Millard Ave & 26th St",41.84456684891,-87.7159103081,860,860,1720,7,2015
421,"MLK Jr Dr & 56th St (*)",41.79342945658,-87.6158532619,854,854,1708,12,2015
388,"Halsted St & 63rd St",41.77938114228,-87.6446208145,839,839,1678,11,2015
552,"Ashland Ave & McDowell Ave",41.80887,-87.66454,789,789,1578,11,2016
408,"Union Ave & Root St",41.819102,-87.643278,787,787,1574,11,2015
446,"Western Ave & 28th St",41.84151770807,-87.6851314409,689,689,1378,11,2015
444,"Albany Ave & 26th St",41.84447501366,-87.7020130128,683,683,1366,11,2015
433,"Kedzie Ave & Harrison St",41.87359967462,-87.7048707493,682,682,1364,11,2015
519,"Wolcott Ave & Fargo Ave",42.016977,-87.677725,663,663,1326,11,2016
270,"Stony Island Ave & 75th St",41.7586696704,-87.586882871,661,661,1322,11,2015
390,"Wentworth Ave & 63rd St",41.78007963264,-87.6297463052,639,639,1278,11,2015
441,"Kedzie Ave & 24th St",41.84819094491,-87.7054137458,617,617,1234,11,2015
637,"Wood St & Chicago Ave (*)",41.895634,-87.672069,601,601,1202,16,2018
573,"State St & 79th St",41.750794,-87.624424,591,591,1182,11,2016
431,"Eberhart Ave & 61st St",41.78414169317,-87.6133078304,576,576,1152,11,2015
580,"Exchange Ave & 79th St",41.751731,-87.552812,571,571,1142,11,2016
547,"Ashland Ave & Pershing Rd",41.823465,-87.665577,562,562,1124,11,2016
659,"Leavitt St & Chicago Ave",41.895501,-87.682017,562,562,1124,15,2018
398,"Rainbow Beach",41.75787144829,-87.54938625,533,533,1066,15,2015
631,"Malcolm X College",41.877618,-87.673895,524,524,1048,19,2018
654,"Racine Ave & Washington Blvd (*)",41.883073,-87.656952,507,507,1014,12,2018
594,"Western Blvd & 48th Pl",41.805661,-87.683392,506,506,1012,11,2016
400,"Cottage Grove Ave & 71st St",41.76571903697,-87.604959713,487,487,974,11,2015
395,"Jeffery Blvd & 76th St",41.75712006802,-87.5758393587,480,480,960,11,2015
430,"MLK Jr Dr & 63rd St",41.78008063659,-87.6159428567,474,474,948,11,2015
407,"State St & Pershing Rd",41.82301523798,-87.6265680185,463,463,926,11,2015
546,"Damen Ave & Pershing Rd",41.823192,-87.676597,449,449,898,11,2016
396,"Yates Blvd & 75th St",41.758768,-87.56644,446,446,892,11,2015
639,"Lakefront Trail & Wilson Ave",41.965845,-87.645361,442,442,884,15,2018
628,"Walsh Park",41.91461,-87.667968,423,423,846,23,2018
585,"Cottage Grove Ave & 83rd St",41.744053,-87.604786,402,402,804,11,2016
524,"Austin Blvd & Chicago Ave",41.894887,-87.774704,401,401,802,7,2016
528,"Pulaski Rd & Lake St",41.885409,-87.726491,393,393,786,11,2016
551,"Hoyne Ave & 47th St",41.808227,-87.67718,392,392,784,11,2016
392,"Perry Ave & 69th St",41.76929308995,-87.6281959291,368,368,736,11,2015
544,"Austin Blvd & Madison St",41.880281,-87.774453,353,353,706,11,2016
534,"Karlov Ave & Madison St",41.88085,-87.727907,345,345,690,11,2016
391,"Halsted St & 69th St",41.76906172032,-87.6446135779,338,338,676,11,2015
575,"Cottage Grove Ave & 78th St",41.753174,-87.605026,323,323,646,11,2016
386,"Halsted St & 56th St",41.79292964599,-87.6449900565,312,312,624,11,2015
440,"Central Park Ave & 24th St",41.8481,-87.715068,298,298,596,11,2015
571,"Vernon Ave & 75th St",41.758361,-87.614138,289,289,578,11,2016
535,"Pulaski Rd & Congress Pkwy",41.874325,-87.725704,283,283,566,11,2016
553,"Elizabeth St & 47th St",41.80839,-87.656526,280,280,560,11,2016
572,"State St & 76th St",41.756971,-87.624621,262,262,524,11,2016
545,"Kostner Ave & Adams St",41.877917,-87.735737,257,257,514,11,2016
533,"Central Park Blvd & 5th Ave",41.875679,-87.71547,253,253,506,11,2016
531,"Central Ave & Lake St",41.887664,-87.765469,235,235,470,11,2016
579,"Phillips Ave & 79th St",41.75182,-87.565211,228,228,456,11,2016
409,"Shields Ave & 43rd St",41.81620767856,-87.6348193497,225,225,450,11,2015
393,"Calumet Ave & 71st St",41.76550800581,-87.616917925,218,218,436,11,2015
530,"Laramie Ave & Kinzie St",41.887832,-87.755527,204,204,408,11,2016
660,"Sheridan Rd & Columbia Ave",42.004583,-87.661406,200,200,400,15,2018
574,"Vernon Ave & 79th St",41.75094,-87.61379,198,198,396,11,2016
632,"Clark St & Newport St",41.94454,-87.654678,194,194,388,15,2018
536,"Kostner Ave & Lake St",41.885928,-87.73541,191,191,382,11,2016
543,"Laramie Ave & Gladys Ave",41.875806,-87.755285,191,191,382,11,2016
586,"MLK Jr Dr & 83rd St",41.743116,-87.6148,191,191,382,11,2016
541,"Central Ave & Harrison St",41.872993,-87.764499,189,189,378,11,2016
529,"Cicero Ave & Lake St",41.886841,-87.745261,186,186,372,11,2016
554,"Damen Ave & 51st St",41.800908,-87.674684,181,181,362,7,2016
542,"Central Ave & Madison St",41.880121,-87.763238,180,180,360,11,2016
577,"Stony Island Ave & South Chicago Ave",41.751173,-87.585337,180,180,360,11,2016
641,"Central Park Ave & Bloomingdale Ave",41.914166,-87.716755,175,175,350,11,2018
555,"Ashland Ave & 50th St",41.803023,-87.664699,170,170,340,11,2016
578,"Bennett Ave & 79th St",41.751785,-87.578496,170,170,340,11,2016
563,"Ashland Ave & 63rd St",41.779374,-87.664843,165,165,330,11,2016
576,"Greenwood Ave & 79th St",41.751294,-87.597552,158,158,316,11,2016
384,"Halsted St & 51st St",41.80183164049,-87.645213904,153,153,306,11,2015
583,"Stony Island Ave & 82nd St",41.746559,-87.586005,152,152,304,11,2016
587,"Wabash Ave & 83rd St",41.743316,-87.622849,150,150,300,11,2016
655,"Hoyne Ave & Balmoral Ave",41.979851,-87.681932,150,150,300,15,2018
567,"May St & 69th St",41.768938,-87.652934,148,148,296,11,2016
658,"Leavitt St & Division St (*)",41.902997,-87.683825,147,147,294,16,2018
595,"Wabash Ave & 87th St",41.736646,-87.622634,145,145,290,11,2016
540,"Laramie Ave & Madison St",41.880207,-87.755337,138,138,276,11,2016
539,"Cicero Ave & Quincy St",41.877613,-87.745405,130,130,260,11,2016
566,"Ashland Ave & 69th St",41.768726,-87.664069,129,129,258,11,2016
550,"Central Ave & Chicago Ave",41.894958,-87.764902,127,127,254,11,2016
548,"Morgan St & Pershing Rd",41.823613,-87.650931,123,123,246,7,2016
643,"Smith Park (*)",41.892048,-87.689397,119,119,238,16,2018
549,"Marshfield Ave & 44th St",41.813996,-87.666589,117,117,234,11,2016
656,"Damen Ave & Walnut (Lake) St (*)",41.885951,-87.677009,117,117,234,16,2018
537,"Kenton Ave & Madison St",41.880708,-87.741018,100,100,200,11,2016
559,"Racine Ave & Garfield Blvd",41.794228,-87.655073,100,100,200,11,2016
588,"South Chicago Ave & 83rd St",41.743921,-87.575225,89,89,178,11,2016
568,"Normal Ave & 72nd St",41.763462,-87.637297,85,85,170,7,2016
564,"Racine Ave & 65th St",41.775393,-87.654308,83,83,166,11,2016
561,"Damen Ave & 59th St",41.78602,-87.674167,81,81,162,11,2016
560,"Marshfield Ave & 59th St",41.786833,-87.666215,77,77,154,11,2016
593,"Halsted St & 59th St",41.787539,-87.644874,74,74,148,11,2016
584,"Ellis Ave & 83rd St",41.744123,-87.599034,68,68,136,11,2016
663,"Lincolnwood Dr & Central St",42.064854,-87.715297,68,68,136,15,2018
538,"Cicero Ave & Flournoy St",41.872131,-87.746619,61,61,122,11,2016
569,"Woodlawn Ave & 75th St",41.75916,-87.595751,60,60,120,11,2016
630,"Kildare Ave & Montrose Ave",41.96108,-87.73569,60,60,120,15,2018
581,"Commercial Ave & 83rd St",41.744615,-87.551208,58,58,116,11,2016
556,"Throop St & 52nd St",41.799659,-87.657195,50,50,100,7,2016
558,"Ashland Ave & Garfield Blvd",41.792822,-87.664429,46,46,92,11,2016
662,"Dodge Ave & Mulford St",42.023463,-87.699595,46,46,92,15,2018
557,"Seeley Ave & Garfield Blvd",41.794087,-87.675478,44,44,88,11,2016
640,"Bernard St & Elston Ave",41.949923,-87.713949,43,43,86,11,2018
644,"Western Ave & Fillmore St (*)",41.868563,-87.686234,41,41,82,12,2018
582,"Phillips Ave & 83rd St",41.744531,-87.56506,40,40,80,11,2016
565,"Ashland Ave & 66th St",41.774074,-87.663815,35,35,70,7,2016
661,"Evanston Civic Center",42.057044,-87.686554,25,25,50,15,2018
664,"Leavitt St & Belmont Ave (*)",41.939354,-87.683282,22,22,44,16,2018
562,"Racine Ave & 61st St",41.783189,-87.654372,19,19,38,11,2016
646,"State St & 54th St",41.796642,-87.625923,17,17,34,11,2018
650,"Eggleston Ave & 69th St (*)",41.768898,-87.635876,15,15,30,12,2018
649,"Stewart Ave & 63rd St (*)",41.779835,-87.634774,5,5,10,12,2018
648,"Carpenter St & 63rd St",41.77987,-87.650919,2,2,4,7,2018
651,"Michigan Ave & 71st St",41.765286,-87.621748,1,1,2,7,2018
653,"Cornell Dr & Hayes Dr",41.780595,-87.584846,1,1,2,11,2018
